Copilot: Microsoft.Copilot
Game Assist: Microsoft.Edge.GameAssist
Game Bar: Microsoft.XboxGamingOverlay
Microsoft 365: Microsoft.MicrosoftOfficeHub
Microsoft Bing: Microsoft.BingSearch
Microsoft Clipchamp: Clipchamp.Clipchamp
Microsoft Teams: MSTeams
Microsoft To Do: Microsoft.Todos
Outlook (new): Microsoft.OutlookForWindows
Paint: Microsoft.Paint
Power Automate: Microsoft.PowerAutomateDesktop
Solitaire & Casual Games: Microsoft.MicrosoftSolitaireCollection
Xbox: Microsoft.GamingApp
Xbox Identity Provider: Microsoft.XboxIdentityProvider
Xbox Live: Microsoft.Xbox.TCUI
Xbox Speech-to-text: Microsoft.XboxSpeechToTextOverlay
Быстрая поддержка: MicrosoftCorporationII.QuickAssist
Домашняя версия для разработчиков: Microsoft.Windows.DevHome
Записки: Microsoft.MicrosoftStickyNotes
Звукозапись: Microsoft.WindowsSoundRecorder
Камера: Microsoft.WindowsCamera
Медиаплеер: Microsoft.ZuneMusic
Мобильные устройства: MicrosoftWindows.CrossDevice
Новости: Microsoft.BingNews
Ножницы: Microsoft.ScreenSketch
Погода: Microsoft.BingWeather
Связь с телефоном: Microsoft.YourPhone
Техническая поддержка: Microsoft.GetHelp
Улучшения совместимости приложений Windows: Microsoft.ApplicationCompatibilityEnhancements
Фотографии: Microsoft.Windows.Photos
Центр отзывов: Microsoft.WindowsFeedbackHub
Часы: Microsoft.WindowsAlarms
Яндекс.Музыка: A025C540.Yandex.Music
